#####
#  #
# . #
#   #
# $ #
# @ #
#   #
#####