#######
#     #
# .$. #
# .$. #
# .$. #
#  @  #
#######